1111111
1000001
1000001
1000N01
1111111